[console_scripts]
airodump = pentest.hooks.airodump:main
amass = pentest.hooks.amass:main
arpscan = pentest.hooks.arpscan:main
crackmapexec = pentest.hooks.crackmapexec:main
curl = pentest.hooks.curl:main
dnsmap = pentest.hooks.dnsmap:main
dnsrecon = pentest.hooks.dnsrecon:main
hping3 = pentest.hooks.hping3:main
http = pentest.hooks.http:main
hydra = pentest.hooks.hydra:main
iscsiadm = pentest.hooks.iscsiadm:main
keimpx = pentest.hooks.keimpx:main
ldapsearch = pentest.hooks.ldapsearch:main
ldeep = pentest.hooks.ldeep:main
msfconsole = pentest.hooks.msfconsole:main
nbtscan = pentest.hooks.nbtscan:main
nikto = pentest.hooks.nikto:main
nmap = pentest.hooks.nmap:main
nmblookup = pentest.hooks.nmblookup:main
patator = pentest.hooks.patator:main
pentest = pentest.__main__:main
pywerview = pentest.hooks.pywerview:main
rpcclient = pentest.hooks.rpcclient:main
showmount = pentest.hooks.showmount:main
skipfish = pentest.hooks.skipfish:main
smbclient = pentest.hooks.smbclient:main
smbmap = pentest.hooks.smbmap:main
sslyze = pentest.hooks.sslyze:main
teRMInator = pentest.hooks.teRMInator:main
tshark = pentest.hooks.tshark:main
wfuzz = pentest.hooks.wfuzz:main

