[console_scripts]
msgcheck = msgtools.parser.check:main
msgconsole = msgtools.console.console:main
msgfindprints = msgtools.debug.findprints:main
msginflux = msgtools.database.influxdb:main
msginitwebapp = msgtools.webapp.webapp:main
msgparser = msgtools.parser.parser:main

[gui_scripts]
msgbandwidthtestecho = msgtools.noisemaker.bandwidthtestecho:main [gui]
msgbandwidthtester = msgtools.noisemaker.bandwidthtester:main [gui]
msgdebug = msgtools.debug.debug:main [gui]
msggoodlistener = msgtools.goodlistener.goodlistener:main [gui]
msginspector = msgtools.inspector.inspector:main [gui]
msglumberjack = msgtools.lumberjack.lumberjack:main [gui]
msgmultilog = msgtools.multilog.multilog:main [gui]
msgnoisemaker = msgtools.noisemaker.noisemaker:main [gui]
msgplot = msgtools.lib.msgplot:main [gui]
msgscope = msgtools.scope.scope:main [gui]
msgserver = msgtools.server.server:main [gui]

[msgtools.parser.plugin]
c = msgtools.parser.c.language
cpp = msgtools.parser.cpp.language
html = msgtools.parser.html.language
java = msgtools.parser.java.language
javascript = msgtools.parser.javascript.language
matlab = msgtools.parser.matlab.language
python = msgtools.parser.python.language
swift = msgtools.parser.swift.language

[msgtools.server.plugin]
serial = msgserver.serial:serial

